NO             bluestone.xpm
F 44, 55,66









SO           greystone.xpm
EA               redbrick.xpm
WE               purplestone.xpm 




C  32  ,   4   ,     5                                





111111111111111111111111111111111
111111111000000000110000000000001
111111111011000001110000000000001
11111111100100N000000000000001111
111111111011000001110000000001001
100000000011000001110111111111111
11111111111111111111111111111
