NO             bluestone.xpm
F 0, 0, 0









SO           greystone.xpm
EA               redbrick.xpm
WE               purplestone.xpm 




C  255  ,   255   ,     255                                





111111111111111
100000010000001
100000000000001
1000000N0000001
100000000000011
111111111111111
