NO             bluestone.xpm
F 0, 0, 0









SO           greystone.xpm
EA               redbrick.xpm
WE               purplestone.xpm 




C  255  ,   255   ,     255                                





1111111111111111111111111
1000100000000000000000001
1000000000000000000000001
1100N00000000000000000001
1000000000000000000000001
1000000000000000000000001
1000000000000000000000001
1000000000000000000000001
1000100000000000000000001
1111111111111111111111111
