NO             bluestone.xpm
F 44, 55,66









SO           greystone.xpm
EA               redbrick.xpm
WE               purplestone.xpm 




C  32  ,   4   ,     5                                





        1111111111111111111111111
        1000000000110000000000001
        1011000001110000000000001
        1001000000000000000001111
111111111011000001110000000001001
100000000011000001110111111111111
11110111111111011100000010001
11110111111111011101010010001
11000000110101011100000010001
1000N000000000001100000010001
10000000000000011101010010001
1100000111010111 101111011111
11110111 1110101 101111010001
11111111 1111111 111111111111
